[
  [" ", " ", " ", " ", " ", " ", " ", " ", " ", " "],
  [" ", "P", " ", " ", " ", " ", " ", " ", " ", " "],
  [" ", " ", " ", " ", " ", " ", " ", " ", " ", " "],
  [" ", " ", " ", "b", "W", "W", "b", " ", " ", " "],
  [" ", " ", " ", " ", " ", " ", " ", " ", " ", " "],
  [" ", " ", "B", " ", " ", " ", " ", "B", " ", " "],
  [" ", " ", " ", " ", " ", " ", " ", " ", " ", " "],
  [" ", " ", " ", " ", " ", " ", " ", " ", " ", " "]
]