[
  [" ", " ", " ", " ", " ", " ", " ", " ", " ", " "],
  [" ", " ", " ", " ", "R", " ", " ", " ", " ", " "],
  [" ", " ", " ", " ", " ", " ", " ", " ", " ", " "],
  [" ", " ", " ", "b", "W", "W", "b", " ", "r", " "],
  [" ", " ", " ", " ", " ", " ", " ", " ", " ", " "],
  [" ", " ", "B", " ", " ", " ", " ", "B", " ", " "],
  [" ", " ", " ", " ", "P", " ", " ", " ", "R", " "],
  [" ", " ", " ", " ", " ", " ", " ", " ", " ", " "]
]