[
  ["B", "W", "W", " ", " ", " ", " ", "W", "B", " "],
  [" ", " ", "W", " ", "P", " ", " ", "W", "W", " "],
  ["W", " ", "W", " ", " ", " ", " ", "W", " ", " "],
  [" ", " ", "W", " ", " ", "B", " ", "W", " ", "W"],
  [" ", "W", "W", " ", " ", " ", " ", "W", " ", " "],
  [" ", " ", "W", " ", " ", " ", " ", "W", "W", " "],
  ["W", " ", "W", " ", " ", " ", " ", "W", " ", " "],
  ["b", " ", "W", " ", "b", " ", " ", "W", "b", "W"]
]